#####################
#P          #     # #
# ######### # # # # #
#     #   # # # #  4#
##### # ### ### #####
# #   #   #     #   #
# # ##### ####### # #
# #     # #   #   # #
#8##### # # # # ### #
# #         # # #   #
# # ### # # # # # ###
#   #   # # #   #   #
##### ### # # ##### #
# #   #   # #       #
# #3#### ## # # ### #
#   #     # # #  1# #
##### # # #   ##### #
#   # # #   #   #   #
# ### # ####### # ###
#     #             E
#####################