#####################
E #9#       #       #
# # # ##### # # ### #
#   # #   #   # #   #
# # # # # ##### # ###
# # # # # #     #   #
# # # # # # # ### ###
# #   # # # #  3#   #
# ## ## #   # ##### #
#       # # #       #
# ##### ### ##### # #
#       #   # #   # #
# ####### ### # ### #
#   #   #   #     # #
### # # ### ## ## ###
#   # #  5# #   #   #
# ### # ### # # ### #
#   # # #     # # # #
### # # # ##### # # #
#     #   #     #  P#
#####################