#####################
#P                  #
#                   #
#                   #
#                   #
#              5    #
#     7             #
#            0      #
#       4           #
#          1        #
#                   #
#        9          #
#           6       #
#      3            #
#             8     #
#    2              #
#                   #
#                   #
#                   #
#                  E#
#####################