#####################
#P          #     # #
# ######### # # # # #
#     #   # # # #  C#
##### # ### ### #####
# #   #   #     #   #
# # ##### ####### # #
# #     # #   #   # #
#C##### # # # # ### #
# #         # # #   #
# # ### # # # # # ###
#   #   # # #   #   #
##### ### # # ##### #
# #   #   # #       #
# #C#### ## # # ### #
#   #     # # #  C# #
##### # # #   ##### #
#   # # #   #   #   #
# ### # ####### # ###
#     #             E
#####################