#####################
#     #   #   # #   #
#P### # # #   # # # #
#   # # # #   #   # #
#   # # # ##### # #5#
#   #   # #     # ###
### ### # #########6#
# #   #           # #
# # #    #### # # # #
#   #     #   # #   #
##### ### # # #######
#     #   # #       #
# ##### ### #       #
# #   #     #       #
# # # # ##### ##### #
# # #       # #     #
# # ####### # # # ###
#     #   # # # # # #
### # # # ###   # # #
#3  # # #       #   E
#####################