#####################
P #        C#      P#
# # # ##### # # ### #
#   # #   #   # #   #
# # # # # ##### # ###
# # # # # #     #   #
# # # # #C# # ### ###
# #   # # # #   #   #
# ## ## #   # ##### #
#         # #   C   #
# ##### ### ##### # #
#   C   #   # #   # #
# ####### ### # ### #
#   #       #     # #
### # # ### ## ## # #
#   # #   # #   #   #
# ### # ### # # ### #
#   # # #C    # # # #
### # # # ##### # # #
#P    #   #     #  P#
#####################