#####################
#P          #     # #
# ######### # # # # #
#     #   # # # #   #
##### # ### ### #####
# #   #   #  C  #   #
# # ##### ####### # #
# #     # #   #   # #
#T##### # # # # ### #
# #       # # # #   #
# # ### #C# # # # ###
#   #   # # #   #   #
##### ### # # ##### #
# #   #   # #       #
# # ####### # # ### #
#   #  C  # # #   # #
##### # # #   ##### #
#   # # #   #   #   #
# ### # ####### # ###
#     #             P
#####################