#####################
#P    #   # #   #   #
# ### # # # # # # # #
#   # # # #   #   # #
# ### # # ##### # # #
#   #   # #     # # #
### ### # ####### # #
# #   C           # #
# # # ####### # # # #
#   #     #   #P#   #
##### ### # # #######
#     #   # #      C#
# ##### ### ####### #
# #   #     #       #
# # # # ##### ## ####
# # #       # #     #
# # #######   ### # #
#     #   # #   # # #
### #C# # ##### # # #
#   #   #         # P
#####################