################
#              #
#              #
#              #
#     P        #
#              #
#              #
#              #
#              #
#              #
#         P    #
#              #
#              #
#              #
#              #
################